G G G G G G G G G G G G W G G G G G G G
G G G G G G G G G G G G W G G G G G G G
G G G G G G G G G G G G W G G G G R G G
G G G G G G G G G G G G W G G G G G G G
G G G G G G G G G G G G G G G G G G G G
G G G G G G G G G G G G G G G G G G G G
G G G G G G G G G G G G G G G G G G G G
G G G G G G G G T G G G G G G G G G G G
G G G G G G G G G G G G G W G G G G G G
G G K G G G G G G G G G G W G G G G G G
G G G G G G G G G G G G W W W G G G G G
G G G G G W W W W W W W W W W G G G G G
G G G G G G G G G G G G G G G G G G G G
G G G G G G G G G H G G G G G G B G G G
G G G G G G G G G G G G G G G G G G G G G